ARE	AA R
ARE(2)	ER
BACKWARD	B AE K W ER D
DOWN	D AW N
FOLLOW	F AA L OW
FORWARD	F AO R W ER D
LEFT	L EH F T
ME	M IY
MOVE	M UW V
RIGHT	R AY T
ROTATE	R OW T EY T
SLEEP	S L IY P
SLOW	S L OW
SPEED	S P IY D
STOP	S T AA P
TIMMY	T IH M IY
TURN	T ER N
UP	AH P
WHAT	W AH T
WHAT(2)	HH W AH T
WHO	HH UW
YOU	Y UW
